-------------------------------------------------------------------------------------------------------------------------------------------------------------------------------------------------------------------------------
-----#####################################-#############----------#############################################-------####-----###########################-----#############################PP############################---##
-------------------#######################-####----------------------------------------------------------------------------------------------------------------################-------------PP##################-------------##
-------------------#######################E####----------------------------------------------------------------------------------------------------------------################-------------PP##################-------------##
-------------------############################--??------------E##----------------------------------------------------#E#--------------------------------------################-------------PP##################-------------##
-----------------------------------------------------------------------------PP--------------------------------------------------------------------------------#-------------------PP-------PP##################-------------##
---------------------------------------------------------------E-------------PP--------------------------------------------------------------------------------#-------------------PP-------PP##################-------------##
--------------------------------------------------------------E-E------------PP-------#--------------------------------------------------------------------------------------------PP-------PP##################-------------##
---------------------######E-##################--??--???---------E---------#EPP#E-------------------------PP----------####-------------------PP-----------------E##########----=---PP-------PP##################-------------##
---------------------#####---##################------------------------PP----PP----PP---PP-------------=--PP--==-------------------------PP--PP----------=--------------------==---PP---########################-----PP------##
---------------------#####---##################------------------------PP----PP----PP---PP------------==--PP--==------------------PP-----PP--PP---------==-------------------===---PP---########################-----PP------##
-----------------------------##################------------------------PP----PP----PP---PP------------==--PP--==------------------PP-----PP--PP--------===-------------C----====---PP---########################-----PP------##
==========--==--=---====================================------==========================================--==--==------====------===============--=========-----=======================--=======================================
