-------------------------------------------------------------------------------------------------------------------------------------------------------------------------------------------------------------------------------
------------------------------------------------------------------------------------------------------------------------------------------------------------------------------------------------------------------------------C
------------------------------------------------------------------------------------------------------------------------------------------------------------------------------------------------------------------------------C
-----------------------------------------------------------------------------------------------------------------------------------------------------------------------------------------------------------------------------CC
-----------------------------------------------------------######E#-----------------------------------------------#E######---------------------------------------------------------------------------------==----------------##
-----------------------------------------------------------------------------------------------------------------------------------------------------------------------------------------------------------------------------##
-----------------------CCCCCCCC-----CCCCCCCCCCCCCC----------------------------CCCCCC---CCCCCC---CCCCCCCCCC-------------------------CCCCCCCCCCCCCCCCCCCCCCCCCCCCCCCCCC------CCCCCCCCCCCCCCCCCCCC----------=-----------------CCCC
CCC--------------------########-----##############----------------------------######---######---##########-------------------------##################################------##################-#----------------------------###-
C##--------------------########-----##############--PP-----########---=-------######---######---##########--==----########---PP----##################################------##################E#--------=-------------------###-
CCCC-------------------########-----##############--PP----------------==------######---######-=-##########--==---------------PP----##################################--PP--####################----------------------------####
#-##-------------------####-###-----##############--PP----------------===-----######---###-##-=-##########--==---------------PP----#############-####################--PP--####################---=--=---------------------##-#
#-##-------------------########-----##############--PP----------------====----######---######-=-##########--==---------------PP----####-#############################--PP--#####-#######-######---=------------------=-----##-#
====================================================================--====--===============================================--==--===================================================================-----------================
