-------------------------------------------------------------------------------------------------------------------------------------------------------------------------------------------------------------------------------
-------------------------------------------------------------------------------------------------------------------------------------------------------------------------------------------------------------------------------
-------------------------------------------------------------------------------------------------------------------------------------------------------------------------------------------------------------------------------
-------------------------------------------------------------------------------------------------------------------------------------------------------------------------------------------------------------------------------
---------------------?---------------------------------------------------------########---###?--------------?-----------###----#??#--------------------------------------------------------==----------------------------------
------------------------------------------------------------------------------------------------------------------------------------------------------------------------------------------===----------------------------------
-----------------------------------------------------------------------------------------------------------------------------------------------------------------------------------------====--------------F-------------------
---------------------------------------------------------------E------------------------------------------------------------------------------------------------------------------------=====-------------CCC------------------
---------------?---#?#?#---------------------PP---------PP------------------#?#--------------#-----#E----?--?--?-----#----------##------=--=----------==--=------------##?#------------======-------------C##------------------
-------------------------------------PP------PP---------PP-----------------------------------------------------------------------------==--==--------===--==--------------------------=======------------CCCCC-----------------
---------------------------PP--------PP------PP---------PP----------------------------------------------------------------------------===--===------====--===-----PP--------------PP-========------------##-##-----------------
---------------------------PP--------PP------PP---------PP---------------------------------------------------------------------------====--====----=====--====----PP--------------PP=========--------=---##-##-----------------
====================================================================--===============---================================================================--========================================================-------------
