---------------------------------------------------------------------------------------------------------------------------------------------------------------------------------------------------------------------
---------------------------------------------------------------------------------------------------------------------------------------------------------------------------------------------------------------------
--------------------------------------------------------------------------------------------------=--------------------------------------------------------------------------------=---------------------------------
--------------------------------------------------------------------------------------------------=--------------------------------------------------------------------------------=---------------------------------
----------##-----------#------------------------#-------#----------?---------------#--------#-----=---------------------------e-----------##----------#-#-#----------------#-------=----##-------##-----#-----e-#----
--------------------------------------------------------------------------------------------------=--------------------------------------------------------------------------------=---------------------------------
--------------------------------------------------------------------------------------------------=--------------------------------------------------------------------------------=---------------------------------
---------------------------------------------------------------------------------------c----------=-----------------c--------------c----------------------------p-----------------c=---------------------------------
?--p--------------=----------------------=------?-----------------=?--p----------------c----------=-----------------c---------#p---c------?-------------?-?p----p-----------=-----c=----------p----p----?------------
---p------p-------=--------------=----c--=--------------p---------=---p---------------=c----------=---------c-------c----------p---c-------p---------------p-c--p-----------=-----c=----------p--p-p-----------------
---p------p-------=------p--p----=----#--=--------------p---------=---p---------------=#----------=---------#-------#----------p---#-------p-----p---------p-#--p-----------=-----#=----------p--p-p---------------p-
---p------p-------=------p--p----=----#--=--------------p---------=---p---------------=#-------=--=---------#-------#----------p---#-------p-----p---------p-#--p-----------=-----#=----------p--p-p---------------p-
=--=---=====--=-=-=-=--===-===-=-=-=-==--===---==--===-==----=----==-===---=-=====----===-=======-=-=-----=-==-===--=-=--=----==---==-=-====-=---==--=-==-==-====-----===--==-=---==--===-==--==-===--=-=-==--===-==-
