---------------------------------------------------------------------------------------------------------------------------------------------------------------------------------------------------------------------
---------------------------------------------------------------------------------------------------------------------------------------------------------------------------------------------------------------------
---------------------------------------------------------------------------------------------------------------------------------------------------------------------------------------------------------------------
---------------------------------------------------------------------------------------------------------------------------------------------------------------------------------------------------------------------
-??-----?------?---------------?-#??--?--?----?-----#--??---#------##---?----------------?------#---#---???----------#----##-----?--------------#---?-#--#----?-------#-?---##?---?--#--?----?-----??#-----------?---
--------------=--------------------------------------------------------------------------------------------------------------------------------------------=------------------------------=--------------------------
--------------=---f----=---------------------------------------=-------------------------------------------------------------------------------------------=------------------------------=----=---------=-=---------
--------------=--=c-cc-=---------------------e----------------c=-------------------------------------------------------------------------------------------==------------------e----------=----=--c----cc=-=---------
-##-----#---=-=#p=#-cc-=-e--=--#--##?-##-#----#-------?##--?--#=p=---?--#-?-------p#e#-?-#-----------p--###-------#-----#--------#-------=-?-------?#=-----==-#-----#---#-----#-=-#----?#==--??=--c??-ecc=-=---?-#-e-
------------=-=-p=cpccc=----=c---------------------=----------c=p=----------------p------------------p--------c--------------=-----------=--c--------=--=--==-------------------=-----c--==----==-c----cc===---------
-----------====-p=-p###=----=#------------------=-==----------#=p=-----=-p------p-p----------=-p--==-p-----=--#=------------p=-=----=--=p=--#-=------=--=--==-------------------=--=--#--==----==-#----##===--=-=-p-=
-----------====-p=-p###=----=#------------------=-==----------#=p=-----=-p------p-p-----=----=-p-===-p-=---=--#=------------p=-=----=--=p=--#==------=-==--==------------=------=--==-#--==----===#----##===-==-=-p-=
===--=-===-===============-=====-============================================-=-==========--====================-==-==========-===-==============================-=-===-===-=====-==========-========================
