---------------------------------------------------------------------------------------------------------------------------------------------------------------------------------------------------------------------
--------c-----#-#---####--------#---#---#-------#-####--#-#-#-#-##-#--#-------#--#----#-----e--##-#----##--#-----#----##----#---#--------c---#-#c--#-#-###----#---#---#--#------#-#------------##---#---#--#-#-----#-
--------#-------#------#--------------------------------------------------------------#--------------------------------------------------#---#-##-------------------------------#------------------------------------
--------c-------#------#--------------------------##-#--------------------------------#----------------------------------------------#---c---#-#c-------------------------------#------------------------------------
#---?#-----e-------------#--?-----=---=--#----?--e-----e---#---#-----------------------?---e-----------------------------------------------#--#-##--#----------?---#----#-------------e#-----------------------------
---------=------------------------=---=------------#-#------------------------------------------------------------------------------------------#--------------------------------------------------------------------
--------c=------------------------=---=----=----#-------------------------------------------#-----------------------------------#--------c------c-------e----------------------------c--------------e----------------
---c----#=----e---=---------------=---=----=----#-------#-------------------------#---e-c---#-------------=?--e-----------------#----#---#--------------#---c----------------e-------#-----p-----e--#--------e-------
--=#??--#=-##---#-=p#----?--#-----=---=----=-#?-#e##-#----=?--??-p-#----------?-------#?#------?----------=?---------------------=---#-=-#---#-#-----?--##--#--#p#----=---------#-?--#-----p---?----#---------#------
--=c----#=p-------=p#-p-c-=-------=--c=c---=#-----------#-=------p-----c----p------p----c-----------------=-----------------p----=---#-=-#--=--##----------pc---p---p-=----------c--c#-----p--c--------pp--=-----p---
--=#-----=p--=----=p#-p-#-=---#---=--#=#---=#------#-#--#-=--=---p-----#---=p------p----#-p-----=---------=###-=------=-----p----==--#-=----=--##----------p#=--p---p-=----=-----#--##-----p#-#--------pp--=-----p-=-
--=#-----=p--=----=p#-p-#-=---#---=-=#=#---=#--=---#-#--#-=--=---p-----#---=p------p----#-p-----=---------=----=------=-----p----==--#-=----=---#----------p#=--p---p-=----=-----#--##-----=#-#--------pp--=-----p-=-
-=====-========================-=-=======-================================-==========-=======-===-=====-=-====================================-========-==================-===============-==========================
