---------------------------------------------------------------------------------------------------------------------------------------------------------------------------------------------------------------------
--------c-----#-#---####------#-#---#---#---#---#-####--#-#-#-#-##-#--#-------#--#----#-----e--##-#----##--#-----#----##----#---#----p---c---#-#c--#-#-###-p--#-p-#---#--#------#-#--------p---##---#---#--#-#-----#-
--------#-------#---#--#------#-------------#-----##-#--#-----------------------------#--------------------#-------------------------p---#---#-##----------p----p---------------#----------p-------------------------
--------c-------#---#--#------#-------------#-----##-#--#-----------------------------#--------------------#-------------------------p---c---#-#c----------p----p---------------#----------p-------------------------
#---?#-----e--------#----#--?-#---=---=--#--#-?--e-#-#-e#--#---#-----------------------?---e---------------#-------------------------p-----#--#-##--#------p---?p--#----#-------------e#---p-------------------------
---------=----------#---------#---=---=-----#------#-#--#--------------------------------------------------#-------------------------p----------#----------p----p--------------------------p-------------------------
--------c=----------#---------#---=---=----=#---#--#-#--#-----------------------------------#--------------#--------------------#----p---c------c-------e--p----p--------------------c-----p--------e----------------
---c----#=----e---=-#---------#---=---=----=#---#--#-#--#-------------------------#---e-c---#-------------=#--e-----------------#----p---#--------------#--pc---p------------e-------#-----pc----e--#--------e-------
--=#??--#=-##---#-=p#----?--#-#---=---=----=##?-#e##-#-###=?--??-p-#----------?-------#?#------?----------=#---------------------=---p-=-#---#-#-----?--##-p#--#p#----=---------#-?--#-----pc--?----#---------#------
--=c----#=p-------=p#-p-c-=---#---=--c=c---=#------#-#--#-=------p-----c----p------p----c-----------------=#----------------p----=---#-=-#--=--##----------#c---#---p-=----------c--c#-----#c-c--------pp--=-----p---
--=#-----=p--=----=p#-p-#-=---#---=--#=#---=#------#-#--#-=--=---p-----#---=p------p----#-p-----=---------=#---=------=-----p----==--#-=----=--##----------##=--#---p-=----=-----#--##-----##-#--------pp--=-----p-=-
--=#-----=p--=----=p#-p-#-=---#---=-=#=#---=#--=---#-#--#-=--=---p-----#---=p------p----#-p-----=---------=#---=------=-----p----==--#-=----=---#----------##=--#---p-=----=-----#--##-----##-#--------pp--=-----p-=-
-=====-========================-=-=======-================================-==========-=======-===-=====-=-====================================-========-==================-===============-==========================
