-------CCC##=
-------C#C--=
-------C#C##=
---------C##=
------------=
------------=
------------=
------------=
------------=
------------=
------------=
------------=
------------=
------------=
------------=
------------=
------------=
------------=
------------=
------------=
------------=
------------=
------------=
------C#####=
------C#####=
------C#####=
------C#####=
------C###-#=
------C#####=
------C#####=
------C#####=
------------=
------------=
------------=
------------=
------------=
------C#####=
------C#####=
------C#####=
------C#####=
------C#####=
------C#####=
------C#####=
------C#####=
------C#####=
------C#####=
------C#####=
------C#####=
------C#####=
------C#####=
------------=
------------=
--------PPPP=
--------PPPP=
------------=
------------=
------------=
------------=
------------=
----#---#---=
----#---#---=
----#---#---=
----#---#---=
----#---#---=
----#---#---=
----E---#---=
----#---#---=
------------=
-------------
-------------
--------=====
---------====
----------===
-----------==
-------------
-------------
------------=
------------=
------C#####=
------C#####=
------C#####=
------C#####=
------C#####=
------C#####=
------------=
------------=
------------=
------C#####=
------C#####=
------C#####=
------C###-#=
------C#####=
------C#####=
------------=
---------====
------------=
------C#####=
------C#####=
------C#####=
------C#####=
------C#####=
------C#####=
------C#####=
------C#####=
------C#####=
------C#####=
------------=
------------=
--------=====
--------=====
------------=
------------=
------------=
------------=
----#---#---=
----E---#---=
----#---#---=
----#---#---=
----#---#---=
----#---#---=
----#---#---=
----#---#---=
------------=
-------------
-------------
--------PPPP=
--------PPPP=
-------------
-------------
------------=
------------=
------C#####=
------C#####=
------C#####=
------C#####=
------C####-=
------C#####=
------C#####=
------C#####=
------C#####=
------C#####=
------C#####=
------C#####=
------C#####=
------C###-#=
------C#####=
------C#####=
------C#####=
------C#####=
------C#####=
------C#####=
------C#####=
------C#####=
------C#####=
------C#####=
------C#####=
------C#####=
------C#####=
------C#####=
------C#####=
------C#####=
------C#####=
------C#####=
------C#####=
------C#####=
------------=
------------=
---------PPP=
---------PPP=
------------=
------------=
------C#####=
------C#####=
------C#####=
------C#####=
------C#####=
------C####-=
------C#####=
------C#####=
------C#####=
------C#####=
------C#####=
------C#####=
------C#####=
------C####-=
------C#####=
------C#####=
------C#####=
------C#####=
------C-E###=
------C#####=
------------=
------------=
------------=
----------===
------------=
-------------
----------=--
-------------
--------=----
-------------
------=------
-------------
----=--------
----=--------
-------------
-------------
------------=
------------=
------------=
------------=
------------=
------------=
-----------==
------------=
------------=
------------=
------------=
------------=
------C#####=
------C#####=
---C##C###--=
-CCC##C--###=
