------------=
------------=
------------=
------------=
------------=
-#----------=
-#----------=
-#----------=
-#----------=
-#----------=
-#-----------
-#-----------
-#----------=
-#----------=
-#-----------
-#-----------
-#----------=
-#-----------
-#-----------
-####--------
-####-------=
-####---###-=
-####---###-=
-####---###-=
-####---###-=
-####---###-=
-####---#---=
-####---E---=
-####-------=
-####---####=
-####---####=
-####---####=
-####---####=
-####---####=
-####---####=
-####---####=
-####---####=
-####---####=
-####---####=
-####---####=
-####---####=
-####---####=
---E#---####=
-####---####=
-####---####=
-####---####=
-####---####=
-#----------=
-#----------=
-#--?---?---=
-#--?---?---=
-#----------=
-#----------=
-#------?---=
-#------?---=
-#------?---=
-------------
-------------
-------------
-------------
-------------
-------------
-------E----=
----E-E-----=
----#--E----=
----#---E---=
-#----------=
-#----------=
-#----------=
-#----------=
-#----------=
-#-------PPP=
-#-------PPP=
-#----------=
-#----------=
-#------#---=
-#------E---=
-#---PPPPPPP=
-#---PPPPPPP=
-#------#---=
-#------E---=
-#----------=
-#----------=
-#-------PPP=
-#-------PPP=
-#----------=
-#-----#----=
-#----------=
-#-------PPP=
-#-------PPP=
-#----------=
-#----------=
-#----------=
-#----------=
-#----------=
-#----------=
-#----------=
-#----------=
-#----------=
-#----------=
-#----------=
-#----------=
-#--------===
-#-------====
-#-----------
-#-----------
-#------PPPP=
-#------PPPP=
-#-----------
-#-----------
-#-------====
---------====
-------------
-------------
-------------
-------------
-------------
-------------
-#--#---#---=
-#--E---#---=
-#--#---#---=
-#------#---=
-------------
-------------
-------------
-------------
-------------
-#-----------
-#----------=
-#----------=
-#--------PP=
-#--------PP=
-#----------=
-#----------=
-#----------=
-#----------=
-#----------=
-#-------PPP=
-#-------PPP=
-#----------=
-#----------=
-#------PPPP=
-#------PPPP=
-#-----------
-#-----------
-#----------=
-#----------=
-#----------=
-#----------=
-#----------=
-#----------=
-#---------==
-#--------===
-#-------====
-------------
-------------
-------------
-------------
-------------
-######-----=
-####---E---=
-####---#---=
-####---#---=
-####---#---=
-####---#---=
-####---#---=
-####---#---=
-####---#--C=
-####---#---=
-####---#---=
-####---#---=
-####-------=
-####------==
-####-----===
-####----====
-#------=====
-#----------=
-#----------=
-#----------=
-#---PPPPPPP=
-#---PPPPPPP=
-#----------=
-#-----------
-#-----------
-#-------###=
-#-------###=
-#-------###=
-#-------###=
-PPPPPPPP###=
-PPPPPPPP###=
-###########=
-###########=
-###########=
-###########=
-###########=
-###########=
-###########=
-###########=
-###########=
-###########=
-###########=
-###########=
-###########=
-###########=
-###########=
-###########=
-###########=
-###########=
-#----------=
-#----------=
-#----------=
-#----------=
-#----------=
-#-------PPP=
-#-------PPP=
-#----------=
-#----------=
-#----------=
------------=
------------=
------------=
-###########=
-###########=
