-CCC##C--###=
-C#C--C###--=
-C#C##C--###=
---C##C###--=
------C#####=
------C#####=
------------=
------------=
------------=
------------=
------------=
------------=
------------=
------------=
--------#---=
--------E---=
--------#---=
------------=
------------=
-----------==
----------===
---------====
--------=====
-------======
------------=
------------=
------------=
----E---E---=
----#-------=
----#-------=
----#-------=
------------=
------------=
--------=====
----------===
------------=
------------=
------------=
------------=
------------=
------------=
------------=
------------=
------------=
------------=
--------PPPP=
--------PPPP=
------------=
------------=
------------=
------------=
------------=
----?---?---=
----?---?---=
----?---?---=
----?---?---=
----?---?---=
------------=
------------=
------------=
------------=
------------=
------------=
------------=
------------=
------------=
------------=
--------#---=
----E-------=
----#-------=
----#-------=
----#-------=
------------=
--------PPPP=
--------PPPP=
------------=
------------=
------------=
--------?---=
--------?---=
----#---?---=
----#---?---=
----E-------=
----#-------=
----#---?---=
--------?---=
--------?---=
------------=
------------=
------------=
------------=
----#--------
----#--------
----#--------
----#--------
------------=
------------=
------------=
------------=
------------=
------------=
------------=
--------PPPP=
--------PPPP=
------------=
-------------
-------------
-------------
------------=
------------=
------------=
------------=
------------=
------------=
----------PP=
----------PP=
------------=
------------=
------------=
------------=
------------=
--------PPPP=
--------PPPP=
------------=
----E-------=
----#----PPP=
----#----PPP=
----#-------=
------------=
-------PPPPP=
-------PPPPP=
------------=
------------=
------------=
------------=
------------=
------------=
------------=
-------------
-------------
-------------
------------=
------------=
------------=
------------=
------------=
------------=
------------=
------------=
------------=
------------=
-------------
-------------
---------====
------------=
------------=
------------=
------------=
------------=
------------=
--------E---=
------------=
------------=
----#-------=
----#-------=
----#-------=
----#-------=
----#-------=
------------=
--------?---=
------------=
----E-------=
------------=
------------=
------------=
---------PPP=
---------PPP=
------------=
------------=
------------=
------------=
------------=
------------=
------------=
--------#---=
----E---#---=
------------=
------------=
------------=
--===========
--===========
------------=
------------=
------------=
------------=
------------=
------------=
------------=
------------=
-----------==
------------=
------------=
------------=
---------C##=
-------CCC##=
-------C#C--=
-------C#C##=
---------C##=
------------=
------------=
------------=
------------=
-------------
