------------=
------------=
------------=
------------=
------------=
-#----------=
-#----------=
-#----------=
-#----------=
-#------?---=
-#------?---=
-#------?---=
-#------?---=
-#------?---=
-#----------=
-#----------=
-#---------==
-#----------=
-#--------===
-#----------=
-#-------====
-#----------=
-#------=====
-#----------=
-#------=====
-#----------=
-#-------====
-#----------=
-#-----E----=
-#----------=
-#-------====
-#----------=
-#--------===
-#----------=
-#----------=
-#----------=
-#----------=
-#----------=
-#----###---=
-#------#---=
-#----###---=
-#----#-----=
-#----#-----=
-#----###---=
-#------#---=
-#----E##---=
-#----------=
-#----------=
-#----------=
-#----------=
-#----------=
-#--#####---=
-#--#####---=
-###----###-=
-###----###-=
-#----------=
-#----------=
-###----#---=
-###----#---=
-###----#---=
-###----#---=
-########---=
-########---=
-#----------=
-#----------=
-###--------=
-########---=
-###----#---=
-###---E#---=
-#----------=
-#----------=
-#--#####---=
-#--#--E#---=
-#----------=
-#----------=
-###----#---=
-###----#---=
-###----#---=
-###----#---=
-#-----------
-#-----------
-#-----------
-#----------=
-#----##----=
-#----##----=
-#----##----=
-#----##----=
-#----##----=
-E----##----=
-#----------=
-#----------=
-#----------=
-#----------=
-#----------=
-#----------=
-#----------=
-#----------=
-#----------=
-#----------=
-#----------=
-#----------=
-#----------=
-#-------PPP=
-#-------PPP=
-#----------=
-#----------=
-#----------=
-#----------=
-#------PPPP=
-#------PPPP=
-#----------=
-#----------=
-#----------=
-#----------=
-#--------PP=
-#--------PP=
-#----------=
-#----------=
-#----------=
-#-----------
-#-----------
-#-------###=
-#-------###=
-#-----------
-#-----------
-#----------=
-#----------=
-#----------=
-#----------=
-#----------=
-#----------=
-#----------=
-#---------==
-#--------===
-#-------====
-#------=====
-#------=====
-------------
-------------
-------------
-------------
-------------
-------------
-------------
-------#----=
-------#----=
-------#----=
-------#----=
-------#----=
-------E----=
------------=
------------=
-------------
-------------
-------------
-------------
-------------
-------------
-------------
---------###=
-#-------###=
-#-------###=
-#-------###=
-#-------###=
-#-------###=
-#-------###=
-#-------###=
-PPPPPPPP###=
-PPPPPPPP###=
-###########=
-###########=
-###########=
-###########=
-###########=
-###########=
-###########=
-#----------=
-#-------PPP=
-#-------PPP=
-#----------=
-#----------=
-#-------PPP=
-#-------PPP=
-#----------=
-#----------=
-#-------PPP=
---------PPP=
------------=
------------=
-###########=
