------------=
------------=
------------=
------------=
------------=
------------=
------------=
------------=
------------=
------------=
------------=
------------=
------------=
------------=
------------=
--------?---=
------------=
------------=
------------=
--------#---=
--------?---=
----?---#---=
--------?---=
--------#---=
------------=
------------=
------------=
----------PP=
----------PP=
------------=
------------=
------------=
------------=
------------=
------------=
------------=
------------=
---------PPP=
---------PPP=
------------=
------------=
------------=
------------=
------------=
------------=
--------PPPP=
--------PPPP=
------------=
------------=
------------=
------------=
------------=
------------=
------------=
------------=
------------=
--------PPPP=
--------PPPP=
------------=
------------=
------------=
------------=
------------=
-------E----=
------------=
------------=
------------=
------------=
-------------
-------------
------------=
------------=
------------=
------------=
------------=
------------=
--------#---=
--------?---=
--------#---=
----#-------=
----#-------=
----#-------=
----#-------=
----#-------=
----#-------=
----#--------
----#--------
-------------
------------=
------------=
----#-------=
----#-------=
----#-------=
----?---#---=
------------=
------------=
------------=
------------=
------------=
--------#---=
--------E---=
------------=
------------=
------------=
------------=
--------?---=
------------=
------------=
----?---?---=
------------=
------------=
--------?---=
------------=
------------=
------------=
------------=
------------=
--------#---=
------------=
------------=
----#-------=
----#-------=
----#-------=
------------=
------------=
------------=
------------=
----#-------=
----?---#---=
----?---#---=
----#-------=
------------=
------------=
-----------==
----------===
---------====
--------=====
------------=
------------=
--------=====
---------====
----------===
-----------==
------------=
------------=
------------=
------------=
-----------==
----------===
---------====
--------=====
--------=====
-------------
-------------
--------=====
---------====
----------===
-----------==
------------=
------------=
------------=
------------=
----------PP=
----------PP=
------------=
------------=
------------=
--------#---=
--------#---=
--------?---=
--------#---=
------------=
------------=
------------=
------------=
------------=
------------=
------------=
----------PP=
----------PP=
-----------==
----------===
---------====
--------=====
-------======
------=======
-----========
----=========
----=========
------------=
------------=
------------=
------------=
------------=
------------=
------------=
------------=
-----------==
------------=
------------=
------------=
---------C##=
-------CCC##=
------FC#C--=
-------C#C##=
---------C##=
------------=
------------=
------------=
------------=
