----#--------
------------=
--------=====
-------c#c##=
----?---?---=
----#---?---=
-------------
------------=
-c#c--c###--=
-----========
---------ppp=
----e---#---=
--------#---=
----------===
-#-----e----=
------------=
-###----#---=
------------=
-------======
--------pppp=
-###########=
-#----------=
-#-------ppp=
-###--------=
---------c##=
----#---?---=
---------====
------------=
----?---#---=
------------=
-###########=
-------------
-#----------=
-------------
----=========
------------=
-#---------==
---------c##=
----=========
---------c##=
-#----------=
----#--------
------------=
------=======
-###########=
--------#---=
----?---?---=
-----------==
-#----###---=
----e---e---=
-###----#---=
-###########=
-#----------=
-###########=
------------=
----e---#---=
-###########=
--------#---=
-#------=====
----#---?---=
-#----------=
----------===
-#------?---=
----#---?---=
-#----------=
-#------pppp=
------------=
-#------#---=
------------=
------------=
-#----------=
---------c##=
------------=
------------=
-------------
----------===
---------ppp=
------------=
-#------?---=
------------=
------------=
-#----------=
-------#----=
---------ppp=
------------=
-------------
-###---e#---=
----?---?---=
-------c#c##=
------------=
----------pp=
----e-------=
-e----##----=
-------------
------------=
-#------?---=
-#--------===
-------------
-#----------=
------------=
------------=
------------=
------------=
-#-----------
-#----------=
-------------
-------======
-###########=
------------=
------------=
-------e----=
----------===
------------=
-#----------=
------------=
------------=
------------=
------------=
-#--------===
-#----------=
------------=
------------=
------------=
------------=
-#-------ppp=
------------=
------------=
------------=
-#----##----=
--------=====
----------===
------------=
------------=
-pppppppp###=
------------=
--------=====
------------=
-c#c--c###--=
------------=
----#-------=
---------====
-###----#---=
----#--------
-###----###-=
-c#c##c--###=
----#-------=
------------=
-#----------=
----#-------=
-#------?---=
------------=
-#-----------
-#----e##---=
-#------#---=
------------=
-pppppppp###=
-------c#c##=
----------===
-#----------=
----?---#---=
-pppppppp###=
--------#---=
-#----------=
----#-------=
---------ppp=
------------=
-#------=====
------------=
----#-------=
-#----------=
-------------
----------===
------------=
-------e----=
------------=
------------=
-###----#---=
---------c##=
-#------?---=
------------=
---------c##=
------c#####=
----e-------=
----#-------=
------------=
------------=
-------------
-pppppppp###=
-------ccc##=
------------=
---------c##=
-#------?---=
-#----------=
-------e----=
------------=
------------=
-#----e##---=
------------=
------------=
---------ppp=
-#-------ppp=
------------=
------------=
-#-------====
------------=
-#-----e----=
--------#---=
------------=
------------=
---------ppp=
------------=
-#--------===
------------=
-#--------===
---------c##=
-------c#c##=
------------=
-#--#####---=
------=======
------------=
-#----------=
------------=
-------------
------------=
-###########=
--------pppp=
---------====
------------=
----#---?---=
------------=
-#--#--e#---=
--------#---=
------------=
------------=
--------pppp=
------------=
------------=
-------------
-------------
----#-------=
------------=
------------=
------------=
-------------
------------=
------------=
-pppppppp###=
---------ppp=
----#-------=
-###########=
--------?---=
------------=
------------=
------------=
-#----------=
-------e----=
---c##c###--=
------------=
-------======
-pppppppp###=
------------=
----#-------=
------------=
----?---#---=
----------===
--------#---=
------------=
---------###=
-c#c##c--###=
------------=
-#-------====
------c#####=
----e---#---=
------------=
--------#---=
--------=====
----e-------=
---------====
-###########=
------------=
-###----#---=
-----------==
------------=
-#------=====
----#---?---=
----?---#---=
--------pppp=
--------?---=
-------------
-------c#c##=
-###----#---=
------------=
